Sumatra
BL - Aceh  (23 daerah)
BB - Sumatera Utara bagian Barat ( Tapanuli ) (18 daerah)
BK - Sumatera Utara bagian Timur ( Pesisir Timur Sumatra ) (15 daerah)
BA - Sumatera Barat  (19 daerah)
BM - Riau  (12 daerah)
BH - Jambi  (11 daerah)
BG - Sumatera Selatan  (17 daerah)
BD - Bengkulu  (10 daerah)
BE - Lampung  (15 daerah)
BN - Kepulauan Bangka Belitung  (7 daerah)
BP - Kepulauan Riau  (7 daerah)
Jawa
B - DKI Jakarta Jakarta Barat  (20 daerah)
D - Jawa Barat ( Bandung Raya tidak termasuk Kabupaten Sumedang ) Kota Bandung  (5 daerah)
E - Jawa Barat (eks keresidenan Cirebon ) Kota Cirebon  (6 daerah)
F - Jawa Barat (eks keresidenan Bogor dan Priangan Barat tidak termasuk Kota Depok) Kota Bogor  (6 daerah)
T - Jawa Barat (eks keresidenan Karawang ) Purwakarta  (4 daerah)
Z - Jawa Barat (eks keresidenan Priangan Timur dan Kabupaten Sumedang) Sumedang  (8 daerah)
G - Jawa Tengah (eks keresidenan Pekalongan ) Kota Pekalongan  (8 daerah)
H - Jawa Tengah (eks keresidenan Semarang tidak termasuk Kabupaten Grobogan ) Kota Semarang  (6 daerah)
K - Jawa Tengah (eks keresidenan Pati dan Kabupaten Grobogan) Pati  (7 daerah)
R - Jawa Tengah (eks keresidenan Banyumas ) Banyumas  (5 daerah)
AA - Jawa Tengah (eks keresidenan Kedu ) Kota Magelang  (7 daerah)
AD - Jawa Tengah (eks keresidenan Surakarta ) Kota Surakarta  (8 daerah)
AB - Daerah Istimewa Yogyakarta Kota Yogyakarta  (6 daerah)
L - Jawa Timur Kota Surabaya  (2 daerah)
M - Jawa Timur (eks keresidenan Madura ) Pamekasan  (5 daerah)
N - Jawa Timur (eks keresidenan Pasuruan - Malang ) Kota Malang  (9 daerah)
P - Jawa Timur (eks keresidenan Besuki ) Bondowoso  (5 daerah)
S - Jawa Timur (eks keresidenan Bojonegoro , Kabupaten â€“ Kota Mojokerto , Lamongan , dan Jombang ) Bojonegoro  (7 daerah)
W - Jawa Timur (eks keresidenan Surabaya ) Gresik  (3 daerah)
AE - Jawa Timur (eks keresidenan Madiun ) Kota Madiun  (7 daerah)
AG - Jawa Timur (eks Keresidenan Kediri ) Kota Kediri  (8 daerah)
A - Banten Kota Serang  (7 daerah)
Kepulauan Nusa Tenggara
DK - Bali  (9 daerah)
DR - NTB ( Pulau Lombok ) (5 daerah)
EA - NTB ( Pulau Sumbawa ) (5 daerah)
DH - NTT ( Pulau Timor ) (8 daerah)
EB - NTT ( Pulau Flores dan kepulauan) (10 daerah)
ED - NTT ( Pulau Sumba ) (4 daerah)
Kalimantan
KB - Kalimantan Barat  (14 daerah)
KH - Kalimantan Tengah  (14 daerah)
DA - Kalimantan Selatan  (13 daerah)
KT - Kalimantan Timur  (10 daerah)
KU - Kalimantan Utara  (5 daerah)
Sulawesi
DB - Sulawesi Utara (Daratan) (12 daerah)
DL - Sulawesi Utara (Kepulauan) (3 daerah)
DN - Sulawesi Tengah  (13 daerah)
DD - Sulawesi Selatan (bagian selatan) (9 daerah)
DW - Sulawesi Selatan (bagian tengah) (4 daerah)
DP - Sulawesi Selatan (bagian utara) (11 daerah)
DT - Sulawesi Tenggara  (17 daerah)
DM - Gorontalo  (6 daerah)
DC - Sulawesi Barat  (6 daerah)
Maluku dan Papua
DE - Maluku  (11 daerah)
DG - Maluku Utara  (10 daerah)
PA - Papua  (9 daerah)
PB - Papua Barat  (7 daerah)
PG - Papua Pegunungan  (8 daerah)
PS - Papua Selatan  (4 daerah)
PT - Papua Tengah  (8 daerah)
PY - Papua Barat Daya  (6 daerah)